Google	google.com
Facebook - フェイスブック - ログイン (日本語)	facebook.com
YouTube - Broadcast Yourself	youtube.com
Yahoo!	yahoo.com
	baidu.com
	wikipedia.org
Welcome to Windows Live	live.com
Twitter	twitter.com
	qq.com
Amazon.com: Online Shopping for Electronics, Apparel, Computers, Books, DVDs &amp; more	amazon.com
Blogger: Create your free Blog	blogspot.com
World's Largest Professional Network | LinkedIn	linkedin.com
Google	google.co.in
淘宝网 - 淘！我喜欢	taobao.com
新浪	sina.com.cn
Yahoo! JAPAN	yahoo.co.jp
MSN Japan	msn.com
WordPress.com	wordpress.com
t.co / Twitter	t.co
Google	google.com.hk
Google	google.de
Electronics, Cars, Fashion, Collectibles, Coupons and More Online Shopping | eBay	ebay.com
Google	google.co.jp
Google	google.co.uk
	googleusercontent.com
Яндекс	yandex.ru
网易	163.com
新浪微博-随时随地分享身边的新鲜事儿	weibo.com
Google	google.fr
Bing	bing.com
Google	google.com.br
Microsoft Corporation: Software, Smartphones, Online, Games, Cloud Computing, IT Business Technology, Downloads	microsoft.com
搜搜更懂你	soso.com
Mail.Ru: почта, поиск в интернете, новости, игры, развлечения	mail.ru
Tumblr	tumblr.com
Welcome - PayPal	paypal.com
Pinterest / Home	pinterest.com
Apple	apple.com
Babylon 9 Translation Software and Dictionary Tool	babylon.com
Welcome&#33;	vk.com
Google	google.it
Google	google.ru
Google	google.es
搜狐-中国最大的门户网站	sohu.com
Blogger: Create your free Blog	blogger.com
craigslist: tokyo classifieds for jobs, apartments, personals, for sale, services, community, and events	craigslist.org
The Internet Movie Database (IMDb)	imdb.com
Welcome to Flickr - Photo Sharing	flickr.com
BBC - Homepage	bbc.co.uk
凤凰网	ifeng.com
土豆网	tudou.com
FC2 -無料ブログ 無料動画 無料ホームページ レンタルサーバー 無料アクセス解析 SEO対策ツールなど-	fc2.com
Free Porn Videos - XVIDEOS.COM	xvideos.com
xHamster's Free Porn Videos	xhamster.com
Live Sex - Hot Live Sex Shows!... LiveJasmin ..	livejasmin.com
优酷-中国第一视频网站,提供视频播放,视频发布,视频搜索 - 优酷视频	youku.com
Ask.com - What's Your Question?	ask.com
GO.com - Official Home Page	go.com
Google	google.com.mx
Google	google.ca
淘宝商城正式更名天猫,品质共享为你而变 tmall.com	tmall.com
ZEDO Advertising Technology Partner	zedo.com
Conduit - Increase User Engagement &amp; Web Traffic	conduit.com
imgur: the simple image sharer	imgur.com
Одноклассники	odnoklassniki.ru
CNN.com International - Breaking, World, Business, Sports, Entertainment and Video News	cnn.com
hao123_上网从这里开始	hao123.com
Free Porn Videos &amp; Sex Movies - Porno, XXX, Porn Tube and Pussy Porn	pornhub.com
Google	google.co.id
AOL.com - News, Sports, Weather, Entertainment, Local & Lifestyle	aol.com
Adobe	adobe.com
AVG インターネットセキュリティ アンチウイルス – ウイルス対策ソフト、セキュリティ対策ソフト、無料版	avg.com
Download music, movies, games, software! The Pirate Bay - The galaxy's most resilient BitTorrent site	thepiratebay.se
Free Cloud Storage - MediaFire	mediafire.com
Manufacturers, Suppliers, Exporters &amp; Importers from the world&#39;s largest online B2B marketplace-Alibaba.com	alibaba.com
Google	google.com.tr
eBay - eine der größten deutschen Shopping-Websites	ebay.de
ESPN: The Worldwide Leader In Sports	espn.go.com
Google	google.com.au
【楽天市場】Shopping is Entertainment! ： インターネット最大級の通信販売、通販オンラインショッピングコミュニティ	rakuten.co.jp
站长之家 - 中国站长站 - 站长资讯 | 我们致力于为中文网站提供动力！	chinaz.com
Google	blogspot.in
About.com: Need. Know. Accomplish.	about.com
WordPress &#8250; Blog Tool, Publishing Platform, and CMS	wordpress.org
Ameba (アメーバ)｜人気のピグや無料ゲーム・ブログで楽しもう！	ameblo.jp
支付宝 知托付！	alipay.com
eBay - one of the UK's largest shopping destinations	ebay.co.uk
Domain Names | The World's Largest Domain Name Registrar - GoDaddy.com	godaddy.com
Google	google.pl
UOL - O melhor conteĂşdo	uol.com.br
Amazon.co.jp： 通販 - ファッション、家電から食品まで【無料配送】	amazon.co.jp
京东商城	360buy.com
人人网，中国领先的实名制SNS社交网络。加入人人网，找到老同学，结识新朋友。	renren.com
Amazon.de: Günstige Preise für Elektronik &amp; Foto, Filme, Musik, Bücher, Games, Spielzeug &amp; mehr	amazon.de
Breaking News and Opinion on The Huffington Post	huffingtonpost.com
Stack Overflow	stackoverflow.com
	bp.blogspot.com
AdF.ly - The URL shortener service that pays you! Earn money for every visitor to your links.	adf.ly
Product reviews and prices, software downloads, and tech news - CNET	cnet.com
	netflix.com
Porn Videos, Sex, XXX, Free Porn Tube - YouPorn	youporn.com
4shared.com - 無料のファイル共有とストレージ	4shared.com
Dailymotion - Watch, publish, share videos	dailymotion.com
globo.com - Absolutamente tudo sobre notícias, esportes e entretenimento	globo.com
豆瓣	douban.com
搜狗搜索引擎 - 上网从搜狗开始	sogou.com
Free Porn Sex Videos - Redtube - XXX Movies - Home of Porno	redtube.com
livedoor	livedoor.com
The New York Times - Breaking News, World News &amp; Multimedia	nytimes.com
Google	google.nl
Google	google.com.sa
Amazon.co.uk: Low Prices in Electronics, Books, Sports Equipment &amp; more	amazon.co.uk
LiveJournal: Discover global communities of friends who  share your unique passions and interests.	livejournal.com
免费网站流量统计_商业媒体统计_广告联盟_数据专家cnzz.com	cnzz.com
National and Local Weather Forecast, Hurricane, Radar and Report	weather.com
Google	google.com.ar
Vimeo, Your Videos Belong Here	vimeo.com
Torrent Search Engine	torrentz.eu
Badooで新しい人との出会い、友達作り、チャット、交流	badoo.com
天涯社区_全球华人网上家园	tianya.cn
reddit: the front page of the internet	reddit.com
Free Porn, Sex, Tube Videos, XXX Pics, Porno Movies - XNXX.COM	xnxx.com
eHow | How to Videos, Articles &amp; More - Discover the expert in you. | eHow.com	ehow.com
default.secureserver.net	secureserver.net
The Largest Social Sharing and Targeting Platform | AddThis	addthis.com
MyWebSearch Home Page	mywebsearch.com
	yieldmanager.com
Bank of America | Home | Personal	bankofamerica.com
Home | Mail Online	dailymail.co.uk
朋友网	pengyou.com
Wiget Media - Home	wigetmedia.com
Tube8 :: Free Sex Videos - The Free Porn Tube Video Site	tube8.com
deviantART: where ART meets application!	deviantart.com
Indiatimes: India News, Business, Movies, Cricket, Shopping, more...	indiatimes.com
Google	google.com.pk
Email Marketing Software &amp; Email Marketing Services from AWeber	aweber.com
goo	goo.ne.jp
Search	searchnu.com
Search-results Search	search-results.com
Google	google.co.th
Spark Real Traffic System : A Premium Advertising Network	sparkstudios.com
58同城 - 中国第一分类信息网站|免费发布信息	58.com
Answers - The Most Trusted Place for Answering Life's Questions	answers.com
WarriorForum - Internet Marketing Forums	warriorforum.com
Google	google.cn
Contextual Online Advertising and Behavioral Marketing Company	clicksor.com
Google	google.com.eg
Dropbox - Simplify your life	dropbox.com
Google	google.co.za
Explore more. Web pages, photos, and videos | StumbleUpon.com	stumbleupon.com
Instagram	instagr.am
360安全中心 - 360安全卫士 - 杀毒软件|免费杀毒软件|企业杀毒软件|安全浏览器	360.cn
	kat.ph
太平洋电脑网	pconline.com.cn
SourceForge - Download, Develop and Publish Free Open Source Software	sourceforge.net
CHASE Home: Personal Banking | Personal Lending | Retirement &amp; Investing | Business Banking	chase.com
56.com - 中国领先的视频分享网站,在线视频观看,视频搜索,视频上传及分享互动	56.com
네이버 :: 나의 경쟁력, 네이버	naver.com
Mozilla — Home of the Mozilla Project — mozilla.org	mozilla.org
Myspace  - マイスペースで世界とつながろう	myspace.com
Image hosting, free photo sharing &amp; video sharing at Photobucket	photobucket.com
SPIEGEL ONLINE - Nachrichten	spiegel.de
BLOGFA :: Free Persian Weblog Service :: وبلاگ فارسی	blogfa.com
FilesTube - Search &amp; Download Files	filestube.com
	amazonaws.com
Wiki communities for everyone! -- Wikia.com	wikia.com
迅雷看看-中国第一高清影视门户 最新电影和最新电视剧在线观看	xunlei.com
Etsy - Your place to buy and sell all things handmade, vintage, and supplies	etsy.com
Adcash : Régie publicitaire	adcash.com
StatCounter - Free Invisible Web Tracker, Hit Counter and Web Stats	statcounter.com
	wikimedia.org
Google	google.com.my
Upload &amp; Share PowerPoint presentations and documents	slideshare.net
	walmart.com
Live Cricket Scores | Cricket news, statistics  | ESPN Cricinfo	espncricinfo.com
Reference.com - A Free Online Encyclopedia & Information Reference	reference.com
DoubleClick: The technology foundation for digital advertising	doubleclick.com
Google	google.co.ve
オンラインで無料のSkypeインスタント通話と固定電話への格安通話 - Skype	skype.com
Booking.com: 218,602 hotels worldwide. Book your hotel now!	booking.com
	fiverr.com
RapidShare – Secure Data Logistics	rapidshare.com
Бесплатный конструктор сайтов - система для создания сайтов - uCoz	ucoz.ru
	depositfiles.com
San Francisco Restaurants, Dentists, Bars, Beauty Salons, Doctors	yelp.com
ZeekRewards - The Rewards Program of a Lifetime!	zeekrewards.com
Outbrain - Related Link Widgets	outbrain.com
Wells Fargo - Personal &amp; Business Banking - Student, Auto &amp; Home Loans - Investing &amp; Insurance	wellsfargo.com
中关村在线	zol.com.cn
MGID: We Help Websites Grow Traffic for FREE	mgid.com
Fox News - Breaking News Updates | Latest News Headlines | Photos &amp; News Videos	foxnews.com
Battle.net	battle.net
天极	yesky.com
All Topics - The Latest News Headlines, Videos and Images - Digg	digg.com
Google	google.com.co
Adult Friend Finder | 出会い系無料チャット/アダルトコミュニティ	adultfriendfinder.com
Free software downloads and software reviews - CNET Download.com	download.com
Onet - informacje, rozrywka, emocje	onet.pl
Social Media Management Dashboard - HootSuite	hootsuite.com
XFINITY by Comcast -- Official Customer Site | Email | Watch TV Online	comcast.net
LiveInternet @ Статистика и дневники, почта и поиск	liveinternet.ru
OptMD.com&nbsp;>&nbsp;FAQ	optmd.com
Latest news, sport and comment from the Guardian | The Guardian	guardian.co.uk
Taringa! - Inteligencia Colectiva	taringa.net
Descargar programas gratis, software, freeware, juegos - Softonic	softonic.com
	allegro.pl
Aktuelle Nachrichten -
	Bild.de	bild.de
WordPress.com &#8212; Get a Free Blog Here	files.wordpress.com
Rediff.com - India, Business, Stock, Sports, Cricket, Entertainment, Bollywood, Music, Video and Breaking news, Rediffmail NG	rediff.com
Google	google.gr
niconico	nicovideo.jp
Google	google.be
Facebook - フェイスブック - ログイン (日本語)	fbcdn.net
Google	google.com.tw
W3Schools Online Web Tutorials	w3schools.com
Squidoo : Welcome to Squidoo	squidoo.com
isoHunt › the BitTorrent & P2P search engine	isohunt.com
Premium WordPress Themes, Web Templates, Mobile Themes | ThemeForest	themeforest.net
ImageShack&#174; - Online Photo and Video Hosting	imageshack.us
Porn Tube, You Porn, Free Porn Movies, Porntube, Sex Tube, Pornotube, Porno Tube, Sextube, Mobile Porn	youjizz.com
Google	google.com.vn
Freebox, la meilleure offre ADSL&nbsp;: Internet, T&eacute;l&eacute;phone, T&eacute;l&eacute;vision	free.fr
Scribd	scribd.com
搜库-专找视频	soku.com
Asia Edition - Wall Street Journal - Latest News, Breaking Stories, Top Headlines - Wsj.com	wsj.com
Terra - Notícias, vídeos, esportes, economia, diversão, música, moda, fotolog, blog, chat	terra.com.br
Domain Name Lookup, Domain Whois | DomainTools	domaintools.com
Watch TV. Watch Movies. | Online | Free | Hulu	hulu.com
Internet Archive: Digital Library of Free Books, Movies, Music & Wayback Machine	archive.org
Petites annonces gratuites d'occasion - leboncoin.fr	leboncoin.fr
Google	google.com.ua
新华网_传播中国 报道世界	xinhuanet.com
Y8.com: Play Free Games Online! Mini Flash Games, Shockwave 3d games, Android games and more - Y8	y8.com
爱奇艺-中国第一影视门户 高清影视剧、网络视频在线观看	iqiyi.com
9GAG - Just for Fun!	9gag.com
Ameba (アメーバ)｜人気のピグや無料ゲーム・ブログで楽しもう！	ameba.jp
站长工具-站长查询-百度排名-百度权重查询-SEO工具-爱站网	aizhan.com
NBA日本語公式サイト	nba.com
Google	google.se
Рамблер	rambler.ru
PHP: Hypertext Preprocessor	php.net
CRM (顧客管理) と ソーシャル エンタープライズ - セールスフォース・ドットコム - CRM Salesforce.com 日本	salesforce.com
互动百科-全球最大中文百科网站	hudong.com
Free Live Sex Webcams - Free Live Cams Sex Chat	cam4.com
Google	google.at
Google	google.ro
CSDN.NET - 全球最大中文IT社区，为IT专业技术人员提供最全面的信息传播和服务平台	csdn.net
Business & Financial News, Breaking US & International News | Reuters.com	reuters.com
HostGator.com - We Eat Up The Competition	hostgator.com
English to French, Italian, German &amp; Spanish Dictionary - WordReference.com	wordreference.com
La Repubblica.it - Homepage	repubblica.it
IT168.com – IT主流资讯互动平台	it168.com
Reviews of Hotels, Flights and Vacation Rentals - TripAdvisor	tripadvisor.com
人命网	people.com.cn
Google	google.com.ph
Shipping, Freight, Logistics and Supply Chain Management from UPS	ups.com
亚马逊-网上购物商城：要网购, 就来Z.cn!	amazon.cn
Orange : t&eacute;l&eacute;phones, forfaits, Internet, actualit&eacute;, sport, video	orange.fr
Digital Products Retailer: Affiliate Program &amp; Sell Online - ClickBank	clickbank.com
はてな	hatena.ne.jp
	media.tumblr.com
Telegraph.co.uk - Telegraph online, Daily Telegraph, Sunday Telegraph - Telegraph	telegraph.co.uk
New URL	samsung.com
有道首页	youdao.com
Home &laquo; Tribal Fusion	tribalfusion.com
「我要啦」网站流量统计 - 领先、免费的网站访问分析服务	51.la
Google	google.cl
Битторрент трекер RuTracker.org	rutracker.org
Socialcam - Free video app for iPhone and Android	socialcam.com
LinkWithin - Related Posts with Thumbnails	linkwithin.com
Hard Sex Tube -  for every fan of hot porn videos and free porn	hardsextube.com
Google	google.com.pe
	china.com
拍拍网:腾讯旗下购物网站	paipai.com
GMX - E-Mail, FreeMail, De-Mail, Themen- &amp; Shopping-Portal - kostenlos	gmx.net
Social Media News and Web Tips – Mashable – The Social Media Guide	mashable.com
Information for the World's Business Leaders - Forbes.com	forbes.com
Libero	libero.it
Download Free Emoticons, Smileys, Winks and Games for MSN, AIM, Yahoo & ICQ Messenger - SweetIM	sweetim.com
Tagged	tagged.com
WEB.DE - E-Mail-Adresse kostenlos, FreeMail, Nachrichten &amp; Services	web.de
Wirtualna Polska - www.wp.pl	wp.pl
	kaskus.us
Google	google.com.sg
Typepad. Share your passions with the world. | Typepad	typepad.com
XING - Das professionelle Netzwerk | XING	xing.com
Dictionary, Encyclopedia and Thesaurus - The Free Dictionary	thefreedictionary.com
赶集网 - 中国最大最全的生活分类信息门户网站|免费发布信息	ganji.com
Targeted Online Advertising Service	angege.com
	pandora.com
SoundCloud - Share Your Sounds	soundcloud.com
搜房网	soufun.com
EzineArticles Submission - Submit Your Best Quality Original Articles For Massive Exposure, Ezine Publishers Get 25 Free Article Reprints	ezinearticles.com
HP - United States | Laptop Computers, Desktops, Printers, Servers and more	hp.com
Free Porn Videos, Free Sex Tube Movies, Mobile Porn - DrTuber.com	drtuber.com
Job Search | one search. all jobs. Indeed.com	indeed.com
Daum - 생활이 바뀐다! Life On Daum	daum.net
ソーシャル・ネットワーキング サービス [mixi(ミクシィ)]	mixi.jp
Google	google.com.ng
HubPages	hubpages.com
MARCA.com	marca.com
乐视网 - 中国第一影视剧视频网站 高清影视剧 在线观看	letv.com
Google	google.ch
Goal.com	goal.com
POF.com &trade; The Leading Free Online Dating Site for Singles &amp; Personals	pof.com
Яндекс.Народ	narod.ru
Welcome to IKEA.com - IKEA	ikea.com
File hosting Letitbit.net &rsaquo; Home	letitbit.net
和讯网-中国最大财经门户网站	homeway.com.cn
爱卡汽车_全球领先的汽车主题社区、汽车资讯、汽车论坛中心	xcar.com.cn
小游戏,4399小游戏大全,网页游戏,双人小游戏 - www.4399.com中国最大的游戏平台	4399.com
Google	google.pt
Small Business Marketing from Constant Contact	constantcontact.com
The Daily Groupon | Coupons, Discounts, and Deals on the Best in St John's	groupon.com
淘宝联盟-我的舞台！	alimama.com
Autoextraction Prohibited	xe.com
CJ - Your Performance Marketing Partner	cj.com
كووورة: الموقع العربي الرياضي الأول	kooora.com
JustBeenPaid - Make Money with JSS3 and JSS Tripler	justbeenpaid.com
Google	blogspot.jp
Target.com : Furniture, Baby, Electronics, Toys,...: Target	target.com
【汽车网站-汽车报价|汽车图片|汽车论坛】-易车网	bitauto.com
酷6网 中国第一视频门户	ku6.com
eBay.it – Compra online da una vasta selezione di oggetti nuovi e usati	ebay.it
	digitalpoint.com
uploaded.to	uploaded.to
开心网	kaixin001.com
MercadoLivre Brasil - Onde comprar e vender de Tudo.	mercadolivre.com.br
Yahoo! Maktoob	maktoob.com
The Official Site of Major League Baseball | MLB.com: Homepage	mlb.com
Dell Official Site - The Power To Do More | Dell	dell.com
orkut -	orkut.com
Weebly - Create a free website and a free blog	weebly.com
Joomla!	joomla.org
Share Files Easily on PutLocker	putlocker.com
	mop.com
USPS - The United States Postal Service (U.S. Postal Service)	usps.com
126网易免费邮--你的专业电子邮局	126.com
Best Buy	bestbuy.com
Le Monde.fr - Actualité à la Une	lemonde.fr
match.com - ネットの婚活を、スマートに、厳格に。マッチ・ドットコム ｜ 世界最大級の恋愛・結婚マッチングサイト	match.com
Freelancer.com - Hire Freelancers & Find Freelance Jobs Online	freelancer.com
电脑之家PChome.net - 最具活力的时尚科技门户	pchome.net
Washington Post: Breaking News, World, US, DC News &amp; Analysis	washingtonpost.com
招聘,找工作求职,上前程无忧	51job.com
Corriere della Sera	corriere.it
Video Games, Wikis, Cheats, Walkthroughs, Reviews, News &amp; Videos - IGN	ign.com
iG - Notícias, Vídeos, Famosos, Esportes, Bate Papo, Infográficos	ig.com.br
中国网络电视台-CNTV	cntv.cn
Google	blogspot.de
価格.com - 「買ってよかった」をすべてのひとに。	kakaku.com
Bloomberg - Business, Financial & Economic News, Stock Quotes	bloomberg.com
American Express Credit Cards, Rewards, Travel and Business Services	americanexpress.com
Stock Photos and Royalty-Free Images by Subscription - Shutterstock	shutterstock.com
Google	google.ie
GitHub · Social Coding	github.com
bet365 - Sports Betting, French Open Tennis Odds and International Football Prices, Casino, Poker, Games, Bingo	bet365.com
A5站长网 | 网络创业必看的网站 admin5.com - 站长信息和服务中心	admin5.com
iStock Photo: Royalty Free Stock Photography, Vector Art Images, Music &amp; Video Stock Footage | iStock	istockphoto.com
Créer un blog gratuit - Le blog des blogs - Annuaire des blogs d'OverBlog	over-blog.com
orkut -	orkut.com.br
Nachrichten - Service - Shopping bei t-online.de	t-online.de
Seesaa ブログ - 無料のブログ作成(blog)サービス	seesaa.net
	10086.cn
Zimbio - Entertainment News, Celebrity News, Celebrity Photos &amp; Videos	zimbio.com
Twitpic - Share photos and videos on Twitter	twitpic.com
@nifty	nifty.com
SEO Software. Simplified. | SEOmoz	seomoz.org
eBay Australia: Buy new &amp; used fashion, electronics &amp; home decor	ebay.com.au
EL PAÍS: el periódico global en español	elpais.com
EroAdvertising - Advertising and Publishing: Home	ero-advertising.com
	akamaihd.net
AT&T; | Cell Phones, U-verse, Digital TV, DSL Internet, and Phone Service	att.com
IN offers Songs, Music, Videos, Games, Movie, Celebs, Download, E Mail, News, Devotion, Search Online &quot;IN.com&quot;	in.com
National Institutes of Health (NIH)	nih.gov
WWW leo.org	leo.org
Small Business CRM | CRM Software for Small Businesses | Infusionsoft	infusionsoft.com
m.milliyet.com.tr	milliyet.com.tr
detikcom : situs warta era digital	detik.com
Create a Social Networking Site with Ning, the Best Social Site Platform	ning.com
海外ホテル予約・国内ホテル予約・航空券・ツアー | エクスペディア (Expedia)	expedia.com
PPTV—每个人的网络电视,海量影视剧,高清体育直播,热点视频在线观看_PPTV每个人的网络电视	pptv.com
Google	google.dz
汽车之家	autohome.com.cn
TechCrunch	techcrunch.com
	dianping.com
Google	google.ae
Seznam – Najdu tam, co hledám	seznam.cz
AliExpress - Buy directly from China	aliexpress.com
VANCL凡客诚品,互联网快时尚品牌，服装、鞋、配饰，箱包，化妆品，网上购物，货到付款，30天无条件退换货	vancl.com
elmundo.es. L&iacute;der de informaci&oacute;n en espa&ntilde;ol	elmundo.es
２ちゃんねる掲示板へようこそ	2ch.net
World Wide Web Consortium (W3C)	w3.org
	777wyx.com
Google	blogspot.fr
Gazeta.pl - Polska i świat - wiadomości | informacje | wydarzenia	gazeta.pl
新たな出会い | チャット | デート | Twoo	twoo.com
Google	google.co.hu
HÜRRİYET - TÜRKİYE'NİN AÇILIŞ SAYFASI	hurriyet.com.tr
Google	google.dk
	trekaklik.com
MYNET - Türkiye'nin lider haber - oyun - spor - magazin - sinema portalı	mynet.com
Google	google.cz
News, Travel, Weather, Entertainment, Sports, Technology, U.S. &amp; World - USATODAY.com	usatoday.com
МММ-2011 Сергей Мавроди Официальный сайт	sergey-mavrodi.com
	uimserv.net
ExtraTorrent.com The World's Largest BitTorrent System	extratorrent.com
Webs - Make a free website, get free hosting	webs.com
WarriorPlus	warriorplus.com
Los Angeles Times - California, national and world news - latimes.com	latimes.com
Google	google.no
FedEx: Shipping, Logistics Management and Supply Chain Management	fedex.com
Email Marketing and Email List Manager | MailChimp	mailchimp.com
Web Hosting, Domain Names, eCommerce - Bluehost.com	bluehost.com
SurveyMonkey: 無料ネット調査・アンケートASP／無料フォーム作成ツール	surveymonkey.com
	39.net
电信上网导航_电脑默认主页首选！	dianxin.cn
2345ÍøÖ·µ¼º½£­ÎÒµÄ¸öÐÔ»¯Ö÷Ò³£­ÖÐ¹ú×îºÃµÄÍøÖ·µ¼º½	2345.com
Google	google.co.il
Tin nhanh VnExpress - Đọc báo, tin tức online 24h	vnexpress.net
环球网_全球生活新门户_环球时报旗下网站	huanqiu.com
	arpg2.com
eBay - Achetez et vendez vos objets neufs ou d'occasion. Enchères, prix fixe, petites annonces - Et vous, vous achetez comment ?	ebay.fr
میهن بلاگ - ابزار قدرتمند وبلاگ نویسی	mihanblog.com
Informer Technologies, Inc.	informer.com
Speedtest.net - The Global Broadband Speed Test	speedtest.net
Amazon.fr : livres, DVD, jeux vidéo, CD, lecteurs MP3, ordinateurs, appareils photo, logiciels et plus encore !	amazon.fr
Download Manager - Free Download | iLivid	ilivid.com
Histats.com Counter ,the free web stats and stat counter, hit counter, free web tracker and tracking tools, professional and free!!	histats.com
ABCNews.com  - Breaking News, Latest News & Top Video News - ABC News	abcnews.go.com
	wretch.cc
	irctc.co.in
ÖÐ¹úÐÂÎÅÍø	chinanews.com
Demonoid.me	demonoid.ph
GSMArena.com - GSM phone reviews, news, opinions, votes, manuals and more...	gsmarena.com
Google	google.co.kr
lyrics of song | words & music	analyrics.com
Shaadi Matrimonials - No 1 for Matrimonial Sites, Matrimony, Indian Marriage Sites, Brides & Relationships	shaadi.com
پیوندها	peyvandha.ir
レンタルサーバをお探しならさくらインターネット	sakura.ne.jp
DRUDGE REPORT 2012&#174;	drudgereport.com
Delicious.com - Discover Yourself!	delicious.com
	twimg.com
Watch movies online for free movie download at movie2k.to	movie2k.to
Do something, Learn something, Share something, Change something  - Meetup	meetup.com
Online Shopping India | Buy Books, Mobiles, Cameras, Laptops, Electronics, Accessories, Lifestyle Products | Flipkart.com	flipkart.com
Бесплатный файлообменник TurboBit.net — обмен файлами до 100 Гб, бесплатный хостинг файлов	turbobit.net
Drupal - Open Source CMS | drupal.org	drupal.org
Celebrity Gossip | Entertainment News | Celebrity News | TMZ.com	tmz.com
Newegg.com - Computer Parts, Laptops, Electronics, HDTVs, Digital Cameras and More!	newegg.com
BIGLOBE	biglobe.ne.jp
RR.com: News, Sports, Email, TV Listings, Videos - Road Runner	rr.com
Naukri.com – Jobs – Jobs in India – Recruitment – Job Search – Employment – Job Vacancies	naukri.com
世纪佳缘交友网：中国最大的严肃婚恋交友网站|免费注册马上寻缘	jiayuan.com
	website-unavailable.com
Le Figaro - Actualités	lefigaro.fr
Jobrapido | Jobs, Job Search, Careers	jobrapido.com
Social network Emoticons and Smileys	funmoods.com
年齢認証 - DMM.R18	dmm.co.jp
Comment &Ccedil;a Marche (CCM) - Communaut&eacute; informatique	commentcamarche.net
Яндекс	yandex.ua
HDFC Bank: Personal Banking Services	hdfcbank.com
	eastmoney.com
One of the world's largest online social shopping malls connecting sellers with shoppers safely and easily -  Multiply	multiply.com
Abril.com - Notícias online, diversão e sites Abril	abril.com.br
114 - 知百事 通天下	114so.cn
太平洋汽车网_精准报价_权威评测_汽车世界,由此精彩	pcauto.com.cn
eNet硅谷动力网站-中国权威IT产品信息与商业流通门户	enet.com.cn
	ovh.net
	agoda.com
Earn Reward Points and Redeem Them For Free Stuff at Swagbucks.com	swagbucks.com
Google	google.fi
Business Insider	businessinsider.com
Zillow - Real Estate, Homes for Sale, Recent Sales, Apartment Rentals	zillow.com
	avito.ru
M,P,NEWMEDIA, GmbH	mpnrs.com
Capital One Mobile Banking	capitalone.com
Free Porn, Sex Videos 4 You, Porno Hub, Porn Tube, XXX Movies	spankwire.com
اليوم السابع	youm7.com
115网盘|网盘|115,我的网盘|免费网络硬盘|网盘搜索|网盘下载-115，改变分享！	115.com
Royalty Free Stock Photos at Fotolia.com	fotolia.com
zanox &#45; Europe&#39;s Leading Performance Advertising Network	zanox.com
Wix Free Website Builder | Wix.com	wix.com
Rapidgator.net: Fast, safe and secure file hosting	rapidgator.net
Engadget	engadget.com
Viadeo.com: Web 2.0 | Business Directory | Groups | Alumni | Jobs | Professional Network	viadeo.com
Free Downloads Encyclopedia - Softpedia	softpedia.com
博客园 - 程序员的网上家园	cnblogs.com
Bpath - Free Web Tools - Banner Exchange, Search Engine Submission, Guestbook, Poll, Counter, Message Board, Tell a Friend, Banner Make and More	hypergames.net
LivingSocial	livingsocial.com
bitly | ♥ your bitmarks	bitly.com
Home Improvement Made Easy with New Lower Prices | Improve &amp; Repair	homedepot.com
	itau.com.br
当当网—网上购物中心：图书、母婴、美妆、家居、数码、家电、服装、鞋包等，正品低价，货到付款	dangdang.com
• Create a Free Website with our Website Builder - Jimdo	jimdo.com
招聘 求职 智联招聘首页	zhaopin.com
Metacafe - Best Videos &amp; Funny Movies	metacafe.com
BlackHatWorld the home of internet marketing	blackhatworld.com
Paid to Click Advertising at ClixSense	clixsense.com
quickmeme - make & share your meme	quickmeme.com
	sinaimg.cn
CHIP Online - Deutschlands Webseite Nr. 1 für Computer, Handy und Home Entertainment	chip.de
Развлекательная социальная сеть Фотострана | Сообщества по интересам | Интернет-Знакомства	fotostrana.ru
Cell Phones - Smartphones: Cell Phone Service, Accessories - Verizon Wireless	verizonwireless.com
Stock Photos and Royalty Free Image Subscription from 123RF Stock Photography	123rf.com
Outsource to Freelancers, IT Companies, Programmers, Web Designers from India, Russia, USA, and more	odesk.com
MarketWatch - Stock Market Quotes, Business News, Financial News	marketwatch.com
Sweepstakes, Online Sweepstakes, Free Sweepstakes, Contests | PCH.com	pch.com
VeryCD电驴大全 - 分享互联网	verycd.com
IBM - United States	ibm.com
Hotfile.com: ワンクリックでファイルホスティング	hotfile.com
Download Free Songs - Free iPod Music Downloads - Top Songs - iMesh.com Music	imesh.com
The Sun | The Best for News, Sport, Showbiz, Celebrities | The Sun	thesun.co.uk
Free Kijiji Canada Classifieds | Free Ads | Petites Annonces Gratuites	kijiji.ca
	adjuggler.net
Adult AdWorld : Adult Advertising Network	adultadworld.com
Discuz! 官方站-PHP 开源论坛 -  Powered by Discuz!	discuz.net
Linkbucks.com - Make money when people leave your website!	linkbucks.com
	livedoor.biz
Alpha Porno - Free XXX porn TUBE MOVIES. Free Sex Video	alphaporno.com
Gute Fragen - hilfreiche Antworten - die Ratgeber Community gutefrage.net	gutefrage.net
Iminent -Free download: Smileys, Emoticons & Games for Facebook, Messengers & Emails!	iminent.com
jQuery: The Write Less, Do More, JavaScript Library	jquery.com
Free Porn Tube, Sex Videos, Porno Clips,XXX Pornstars- Keez movies	keezmovies.com
Varzesh3.com |  ورزش 3 | Football | فوتبال | sport	varzesh3.com
WebMD - Better information. Better health.	webmd.com
グルメ・レストランガイド [食べログ]	tabelog.com
News.com.au | News Online from Australia and the World | NewsComAu	news.com.au
美团网 - 每天团购一次，精品消费指南 - 为您提供最好的团购服务	meituan.com
SiteSell.com, E-business Success. Simple. Real	sitesell.com
wikiHow - The How-to Manual That You Can Edit	wikihow.com
RetailMeNot: Coupon Codes, Coupons, Promo Codes, Free Shipping and Discounts for Thousands of Stores	retailmenot.com
Firebug	getfirebug.com
虎扑体育 - 你的体育全世界！	hupu.com
一淘网-最专业的购物搜索｜想购物，先一淘｜全网搜索 综合比较 比价省钱	etao.com
eBay India - Online Shopping Mall: Free Auctions, Shop/Buy/Sell Mobiles, Cameras, Apparel, Computers, Bollywood Clothes &amp; Indian Products	ebay.in
探しあう検索NAVER（ネイバー）	naver.jp
Share Book Recommendations With Your Friends, Join Book Clubs, Answer Trivia	goodreads.com
多玩游戏网 | 多玩游戏 多交朋友	duowan.com
Fast, Free Image Hosting - ImageBam	imagebam.com
Targeted Online Advertising Service	lzjl.com
William Hill Online Betting, Sports Betting, Poker, Casino, Bingo, Games	williamhill.com
Online Casino &amp; Online Poker Room - 888.com	888.com
Google FeedBurner	feedburner.com
Welcome / Bienvenue	gc.ca
Acesse	acesse.com
Spazio web gratis, hosting php mysql | Altervista	altervista.org
پرشین بلاگ نخستین سرویس وبلاگ فارسی	persianblog.ir
Issuu - You Publish	issuu.com
MercadoLibre Argentina - Donde comprar y vender de todo.	mercadolibre.com.ar
People.com : The #1 Celebrity Site for breaking news, celebrity pictures and star style	people.com
	am10.ru
Zing tin tức & giải trí - Mạng xã hội	zing.vn
LiveScore.com : Soccer Live Scores	livescore.com
机票,机票查询,特价机票,打折机票-去哪儿旅游搜索引擎Qunar.com	qunar.com
GI Academie	gi-backoffice.com
Яндекс	ya.ru
Stock Market News, Business News, Financial, Earnings, World Market News and Information - CNBC	cnbc.com
Weather Forecast & Reports - Long Range & Local | Wunderground | Weather Underground	wunderground.com
百姓网	baixing.com
Virgilio	virgilio.it
Netlog	netlog.com
sahibinden.com - Satılık, Kiralık, 2.El, Emlak, Oto, Araba, Alışveriş, Hizmet, Kariyer, İş İlanları, Bilgisayar, Cep Telefonu, Tekne, Motosiklet, İş Makinesi fiyatları - ilan ve alışverişte ilk adres	sahibinden.com
beeg.	beeg.com
Personal Banking Services | Corporate Banking | Online Personal Banking in India | Business banking | NRI Banking | ICICI Bank - Standard View	icicibank.com
SAPE.RU - покупка и продажа ссылок.	sape.ru
NeoBux: The Innovation in Paid-to-Click Services	neobux.com
Quikr Classifieds: Post Free Classifieds Ads, Search Free Classified Ads online | Free Classified Advertisement on Quikr Classifieds	quikr.com
网易博客-网易	blog.163.com
LetMeWatchThis | 1Channel - Watch Movies Online Free - Just Added	1channel.ch
Microsoft Business Productivity Online Services and Software - BPOS	microsoftonline.com
Games at Miniclip.com - Play Free Online Games	miniclip.com
	lenta.ru
java.com: Java + You	java.com
Главная	gi-akademie.com
	yomiuri.co.jp
Allrecipes.com - recipes, menus, meal ideas, food, and cooking tips.	allrecipes.com
	macys.com
Immobilien, Wohnungen und Häuser bei ImmobilienScout24 mieten, kaufen, inserieren	immobilienscout24.de
Linkbucks.com - Make money when people leave your website!	linkbucksmedia.com
質問・疑問に答えるQ&amp;AサイトOKWave	okwave.jp
AS.com: noticias deportivas en la red	as.com
mobile.de – Gebrauchtwagen und neue Autos – Deutschlands größter Fahrzeugmarkt.	mobile.de
カンタン、快適なブログライフを始めよう！ | エキサイトブログ (blog)	exblog.jp
中国电信网上营业厅 公测版	189.cn
USTREAM, You're On. Free LIVE VIDEO Streaming, Online Broadcasts. Create webcasts, live stream videos on the Internet. Live streaming videos, TV shows	ustream.tv
Porn Tube, Free Sex Videos, HD Porn Clips / Bravo Tube	bravotube.net
MapQuest Maps - Driving Directions - Map	mapquest.com
FREE XXX Porn Videos & Sex Movies - Porn Movies & Pics - Porn Tube NuVid.com	nuvid.com
РосБизнесКонсалтинг - новости, акции, курсы валют, погода, доллар, евро	rbc.ru
International Jobs, Global Jobs, Jobs Abroad | Monster.com	monster.com
	moneycontrol.com
ImageVenue.com -  Image Hosting and Image Upload	imagevenue.com
Web Conferencing &#124; GoToMeeting	gotomeeting.com
ExoClick.com - The Innovative Ad Network	exoclick.com
Xtube :: Gay Porn Tube With Hot Gay Men Having Hardcore Anal Sex	xtube.com
	nokia.com
nu.nl | Het laatste nieuws het eerst op nu.nl	nu.nl
Who.is: Whois Lookup, Website, Domain Name, and IP Tools - Who.is	who.is
BuzzFeed	buzzfeed.com
	sponichi.co.jp
Android &amp; Windows Phone: Tablets, Apps, &amp; ROMs @ xda-developers	xda-developers.com
AccuWeather.com	accuweather.com
	twcczhu.com
Bleacher Report | Entertaining sports news, photos and slideshows	bleacherreport.com
MyFreeCams.com - The #1 adult webcam community. Free live webcams and video-chat.	myfreecams.com
	nikkei.com
Video Game Reviews & News - GameSpot.com	gamespot.com
Klout | The Standard for Influence	klout.com
MercadoLibre México - Donde comprar y vender de todo.	mercadolibre.com.mx
TradeDoubler - The European Affiliate Network	tradedoubler.com
中国天气网-专业天气预报、气象服务门户	weather.com.cn
SAPO - Portugal Online!	sapo.pt
ShareASale	shareasale.com
Folha Online	folha.uol.com.br
	linksynergy.com
Oracle | Hardware and Software, Engineered to Work Together	oracle.com
Excite エキサイト	excite.co.jp
Ì«Æ½ÑóÓÎÏ·Íø_ÓÎÏ·ÌåÓý¾º¼¼µÚÒ»ÃÅ»§	pcgames.com.cn
»Û´ÏÍø_ÖÐ¹úÁìÏÈµÄB2Bµç×ÓÉÌÎñÆ½Ì¨¡¢µç×ÓÉÌÎñÍøÕ¾	hc360.com
Justin.tv - Streaming live video broadcasts for everyone	justin.tv
Google	google.co.ma
MyEgy - افلام عربي - افلام اجنبي - اغاني - كليبات - برامج - العاب	myegy.com
Sport : toute l'actualitĂŠ sportive sur l'EQUIPE (Match en direct, Football, Rugby, Tennis, Nba, F1)	lequipe.fr
21CN - ÏíÊÜ¿í´øÉú»î	21cn.com
Sears International: Shop online, send worldwide with great shipping rates	sears.com
Google	google.sk
Company Profiles &amp; Company Information on Manta	manta.com
	meilishuo.com
Masrawy- First Egyptian Portal - Ù&hellip;ØµØ±Ø§Ù&circ;Ù&Scaron; - Ø£Ù&circ;Ù&bdquo; 
Masrawy- First Egyptian Portal - مصراوي - أول وأكبر بوابة مصرية	masrawy.com
SlutLoad &trade; - Free Porn Videos / Upload Porn For Free	slutload.com
Free classifieds - backpage.com	backpage.com
领先的域名注册与云计算服务提供商-中国万网(www.net.cn)	www.net.cn
Roulette Bot Plus: strategy software (free download)	roulettebotplus.com
Genealogy, Family Trees &amp; Family History Records at Ancestry.com	ancestry.com
Breaking News Headlines: Business, Entertainment & World News - CBS News	cbsnews.com
Matomy Media	xtendmedia.com
Play Free Online Games | Pogo.com&reg;	pogo.com
FOX Sports on MSN l Sports News, Scores, Schedules, Videos and Fantasy Games	foxsports.com
Breaking News, Analysis, Politics, Blogs, News Photos, Video, Tech Reviews - TIME.com	time.com
wetter.com: Wetter, Wettervorhersage, Wetterbericht, Reise	wetter.com
Website Templates | Web Templates	templatemonster.com
Zynga Profile	zynga.com
Cell Phones, Smartphones & Mobile Phones from BlackBerry.com	blackberry.com
Snapdeal.com - Online Shopping India with Best Deals on Products, Retail, Travel & Services	snapdeal.com
whos.amung.us	amung.us
LIVESTRONG.COM - Lose Weight &amp; Get Fit with Diet, Nutrition &amp; Fitness Tools | LIVESTRONG.COM	livestrong.com
The Best Free Porn Tube, XXX, Porno and Sex Videos - PORN.COM	porn.com
PornHubLive - Live Sex Chat, Sex Shows and Webcam Sex - Amateur Cams and Pornstars	pornhublive.com
timeanddate.com	timeanddate.com
TinyPic - Free Image Hosting, Photo Sharing &amp; Video Hosting	tinypic.com
yfrog — Share, Converse and Connect	yfrog.com
	cocolog-nifty.com
WebMoney - система расчетов on-line	webmoney.ru
Slickdeals: The Best Deals, Coupons &amp; Discounts on Laptops, Computers, LCDs, TVs, Dell, HP, Apple, Amazon	slickdeals.net
Talent Management Software - Talent Intelligence | Taleo	taleo.net
小说阅读_起点中文小说网|免费小说,玄幻小说,武侠小说,言情小说,小说网各类小说下载	qidian.com
海外の格安ホテル予約はホテルズドットコム- Hotels.com Japan | Wake up Happy	hotels.com
cnBeta.COM_ÖĐÎÄŇľ˝ç×ĘŃśŐž	cnbeta.com
FreakShare - Easy One-Click File Hosting	freakshare.com
Welcome to Indian Railway Passenger reservation Enquiry	indianrail.gov.in
Email Marketing Software &amp; Autoresponder from GetResponse	getresponse.com
Kickstarter	kickstarter.com
Justdial	justdial.com
	blogspot.com.ar
Tuts+ Premium | The best way to learn creative and technical skills.	tutsplus.com
	ocn.ne.jp
Elance | Instant access to freelance professionals, experts, and consultants - Get work done on Elance	elance.com
Social & Mobile Application Development Platform - Force.com	force.com
All the Best Games - In Just 1 Click!	incredibar.com
Coupons.com | Install	coupons.com
Read Manga Online for Free. Online Manga Reader	mangareader.net
NDTV.com: India, Business, Bollywood, Cricket, Video and Breaking News	ndtv.com
فتكات مواقع المرأة	fatakat.com
	cmbchina.com
MCSV | MailChimp	list-manage.com
沃门户-中国联通wo门户	wo.com.cn
КиноПоиск.ru - Все фильмы планеты	kinopoisk.ru
OkCupid |  Free Online Dating	okcupid.com
Trulia - Real Estate, Homes for Sale, Apartments for Rent, Local data	trulia.com
	geocities.jp
52pk游戏网 www.52pk.com - 都说这是最好的游戏网站！	52pk.net
	icbc.com.cn
	cltrda.com
Free Porn Videos, Porn Tube, Free Porn, Free Porno Movies, Free Sex	tnaflix.com
Google	google.co.nz
Disney | Official Home Page for All Things Disney	disney.go.com
Ultime notizie sportive - La Gazzetta dello Sport	gazzetta.it
Customer Experience Management - CX  | RightNow	custhelp.com
Shop clothes for women, men, maternity, baby, and kids | Gap	gap.com
Lowe's Home Improvement: Appliances, Tools, Hardware, Paint, Flooring	lowes.com
Priceline.com | Best deal on Hotels, Flights, Cars, Vacations &amp; more!	priceline.com
The best of online dating sites with singles chat rooms - BeNaughty.com	benaughty.com
Free SMS, Send Free SMS, Send Free SMS to india, Free email alerts, email2SMS, SMS Alerts,Bill Reminders, EMI Reminders, Loan Reminders, TV Shows Reminders, Future SMS, Mobile Bill Reminders	way2sms.com
Skyrock.com	skyrock.com
Barnes&nbsp;&amp;&nbsp;Noble - Books, Textbooks, eBooks, Toys, Games, DVDs and More	barnesandnoble.com
Mtime时光网：电影,社区,你和我	mtime.com
Shoes, Clothing, and More | Zappos.com	zappos.com
中国建设银行	ccb.com
Cheap Domain Names Registration, Domain Transfer, SSL Certificates, Free DNS, Privacy Protection &bull; Namecheap.com	namecheap.com
Jobs &amp; Job Search Advice, Employment &amp; Careers | Careerbuilder.com	careerbuilder.com
nikkei BPnet 〈日経BPネット〉	nikkeibp.co.jp
Quora	quora.com
爱美网-女性|时尚|美容-lady8844.com-我的美丽,由此开始!2012年女性最新流行时尚美容资讯!Top Fashion & Beauty Portal For Woman	lady8844.com
ShopAtHome.com | Up to 35% Cash Back, Coupons, Promo Codes + Deals	shopathome.com
Sulekha.com US & Canada - Indian Events & Movie Tickets, Classifieds, Roommates, IT Jobs & Training, Yellow Pages & Recipes	sulekha.com
heise online | IT-News, c't, iX, Technology Review, Telepolis	heise.de
Smashing Magazine	smashingmagazine.com
KAYAK - Cheap Flights, Hotels, Airline Tickets, Cheap Tickets, Cheap Travel Deals - Compare Hundreds of Travel Sites At Once	kayak.com
中国网--网上中国	china.com.cn
PHP Scripts, WordPress Plugins, HTML5, jQuery, and CSS | CodeCanyon	codecanyon.net
	nhk.or.jp
Verizon.com	verizon.com
	wiktionary.org
Cracked.com - America's Only Humor Site | Cracked.com	cracked.com
Online Shopping India - Buy Shoes, Clothing, Bags, Jewellery in India | Jabong.com	jabong.com
Free Porn Videos | 4tube	4tube.com
Free Porn Movies | PornTube.com	porntube.com
V9 Portal de Sites - A minha página inicial - O melhor e o mais completo site de navegação do Brasil!	v9.com
	zx915.com
BabyCenter | Homepage - Pregnancy, Baby, Toddler, Kids	babycenter.com
FileHippo.com - Download Free Software	filehippo.com
So-net	so-net.ne.jp
	mybrowserbar.com
Portal INTERIA.PL - więcej niż się spodziewasz!	interia.pl
Iranian Social Network - جامعه مجازی ایرانیان	cloob.com
Bodybuilding.com - Huge Online Supplement Store & Fitness Community!	bodybuilding.com
财付通 - 会支付 会生活	tenpay.com
Intuit&reg; Small Business | Accounting Software, Pay by Mobile, Free Website Builder	intuit.com
Tata Indicom	tataindicom.com
Blog.com &#8212; What's your story?	blog.com
Ad Magnet | Largest Indian Online Ad Network	admagnet.net
日本郵政ホーム‐日本郵政	japanpost.jp
Dedicated Server Hosting, Cloud Servers, &amp; Managed Hosting Plans	softlayer.com
adscale.de	adscale.de
ÖÐ¹ú¹ã²¥Íø Ò»ÍøÌýÌìÏÂ	cnr.cn
Google	google.az
PopAds - Home	popads.net
Welcome to Windows Live	outlook.com
51游戏社区_网页游戏社区化第一平台_上51.com，真人配对玩游戏	51.com
BitShare.com - Free File Sharing and Storage	bitshare.com
YP.com - Yellow Pages, the new YELLOWPAGES.COM	yellowpages.com
JXLIU.COM	jxliu.com
爱丽时尚-懂得选择-生活更美-爱丽AILI.COM	aili.com
SEOWHY搜外：SEO优化技术学习门户，提供SEO培训和交流平台	seowhy.com
Woot	woot.com
Streamate - Live Sex Web Cam Video Chat - Free Memberships, XXX Live Sex Girls	streamate.com
AlloCiné : Cinéma, Séries TV, Stars, Vidéos, DVD et VOD	allocine.fr
Поисковые системы, оптимизация и продвижение сайта - SearchEngines.ru	searchengines.ru
ライフハッカー［日本版］	lifehacker.com
PIXNET 痞客邦 ログイン	pixnet.net
Free Porn Videos @ H2Porn	h2porn.com
	mediaset.it
MySQL ::  The world's most popular open source database	mysql.com
Southwest Airlines | Book Flights, Airline Tickets, Airfare	southwest.com
Nachrichten und aktuelle Informationen aus Politik, Wirtschaft, Sport und Kultur- WELT ONLINE	welt.de
Overstock.com: Online Shopping - Bedding, Furniture, Electronics, Jewelry, Clothing &amp; more	overstock.com
	hlwan.net
CBS New York	cbslocal.com
ASOS | Shop women's fashion & men's clothing | Free Delivery & Returns	asos.com
hi5	hi5.com
	eluniversal.com.mx
News Headlines | Entertainment | Blogs | Holiday | Living | Videos | Indian Language site - Oneindia	oneindia.in
The Official WhitePages - Find People for Free	whitepages.com
Pay Per Click Advertising - In Text Ads for Websites by Infolinks	infolinks.com
Tabnak.IR | تابناك	tabnak.ir
	rottentomatoes.com
mp3skull.com - Free Mp3 Download	mp3skull.com
太平洋女性网_全国领先的专业女性网站	pclady.com.cn
KOMPAS.com	kompas.com
	6.cn
U.S. Bank Online Banking - Personal Banking | Loans and Credit | Investing and Wealth	usbank.com
ギズモード・ジャパン	gizmodo.com
Subscene - Subtitles for International TV-Series and Movies	subscene.com
	blogimg.jp
	last.fm
招商热线-搜狐焦点	focus.cn
MSN中文网：时尚生活 白领门户; (MSN官方下载)	msn.com.cn
Stack Exchange - Free, Community-Powered Q&A;	stackexchange.com
Free Porn Videos - Porntube Videos | PornerBros.com	pornerbros.com
Magento - Home  - eCommerce Software for Growth	magentocommerce.com
Hide My Ass! Free Proxy and Privacy Tools - Surf The Web Anonymously	hidemyass.com
Лучшие за сутки / Хабрахабр	habrahabr.ru
Google	google.bg
Báo điện tử của TW Hội Khuyến Học Việt Nam - Diễn đàn Dân Trí Việt Nam	dantri.com.vn
	dict.cc
Network Abuse - ClickBank	clickbank.net
Free Porn Movies - Tube Galore . com	tubegalore.com
Welcome to Posterous Spaces	posterous.com
Google	google.lk
GISMETEO.RU: Погода в России. Точный прогноз погоды (метеопрогноз) на сегодня, завтра, выходные, неделю.	gismeteo.ru
Beemp3.com - MP3 Search &amp; Free MP3 Downloads	beemp3.com
	logsoku.com
TD Bank Group - Banking, Wealth Management & Insurance | TD Bank Group	td.com
ODP - Open Directory Project	dmoz.org
ÒÁÐãÅ®ÐÔÍø-ÎÒÃÇÖÂÁ¦ÓÚ×î×¨ÒµµÄÅ®ÐÔÊ±ÉÐÃÅ»§ÍøÕ¾	yxlady.com
Businessweek - Business News, Stock Market & Financial Advice	businessweek.com
Online community for artists[pixiv]	pixiv.net
Email Marketing and Social Media Marketing Software - iContact	icontact.com
SEMRush - service for competitors research, shows organic and Ads keywords for any site or domain	semrush.com
健康之路_最全面健康生活指导网站	xyxy.net
NHL.com - The National Hockey League	nhl.com
Google	google.com.qa
TV Programm heute | aktuelle Informationen zum RTL Fernsehprogramm - RTL.de	rtl.de
	ca.gov
Free classifieds in India, Classified ads in India, Online Classified Advertising	olx.in
Wired.com	wired.com
1&amp;1 Internet AG - DSL, Hosting, Mobile Internet, Domain, Server	1und1.de
Free Website Builder | Make Your Own Website with Free Templates at uCoz.com	ucoz.com
Google	google.com.kw
San Francisco Bay Area &mdash; News, Sports, Business, Entertainment, Classifieds: SFGate	sfgate.com
HowStuffWorks &quot;Learn how Everything Works!&quot;	howstuffworks.com
Paper.li – Be a publisher	paper.li
Remote Access and Remote Desktop Software for Your Computer | LogMeIn	logmein.com
Dreamstime Stock Photography: download free stock photos &amp; royalty free images	dreamstime.com
HABERTÜRK-TÜRKİYE'NİN EN BÜYÜK İNTERNET GAZETESİ	haberturk.com
Ň×Ń¸Íř-×¨ŇľľÄľçÄÔĄ˘ĘýÂëźŇľçĄ˘ĘÖťúĄ˘ĆűłľÓĂĆˇĄ˘ĐŹˇţ°ŮťőÍřÉĎĘýÂë´óÂôłĄ	51buy.com
United Kingdom jobs, cars, property, free classifieds and more - Gumtree.com	gumtree.com
Dedicated Server Hosting, Cloud Servers, &amp; Managed Hosting Plans	theplanet.com
QIP.RU: почта, поиск, новости, знакомства, игры и развлечения	qip.ru
1号店,只为更好的生活	yihaodian.com
Nieuws | Altijd op de hoogte van het laatste nieuws met Telegraaf.nl	telegraaf.nl
Traffic Holder Auto System / Buy &amp; Sell Adult Traffic	trafficholder.com
L'Internaute : Le magazine de l'internet, des loisirs, de la culture et de la d&eacute;couverte	linternaute.com
インプレス グループ	impress.co.jp
HubSpot All-in-One Marketing Software - Free Demo	hubspot.com
Adult-Empire.com	adult-empire.com
Aftonbladet: Sveriges nyhetskälla och mötesplats	aftonbladet.se
Nextag - Compare Prices Before you Buy	nextag.com
Empower Network | Building a business while having a life.	empowernetwork.com
Tv-Links : Free Movies links, Watch Tv Shows links online, Anime, Documentaries	tv-links.eu
Reviews and News on Tech Products, Software and Downloads | PCWorld	pcworld.com
Find Real Estate, Homes for Sale &amp; Houses for Rent on REALTOR.com - Realtor.com&reg;	realtor.com
Personal banking: Bank Accounts, Mortgages, Online | HSBC Bank UK	hsbc.co.uk
Google	google.com.do
Sports - CBSSports.com Sports News, Fantasy Scores, Sports Video	cbssports.com
Citibank Online - Banking, Credit Cards, Lending &amp; Investing - Citibank®	citibank.com
小游戏,7k7k在线小游戏,双人小游戏,7k7k小游戏大全 - www.7k7k.com	7k7k.com
foursquare	foursquare.com
EUROPA – EU website | Choose your language | Choisir une langue | Wählen Sie eine Sprache	europa.eu
TOM.COM	tom.com
Urban Dictionary, May 31: Wall Street	urbandictionary.com
Inbox.com	inbox.com
Meet New People	menepe.com
New York News, Traffic, Sports, Weather, Photos, Entertainment, and Gossip - Homepage - NY Daily News	nydailynews.com
AFIMET.COM - конструктор сайтов	afimet.com
Flippa: The #1 Marketplace for Buying and Selling Websites	flippa.com
McAfee SiteAdvisor Software – Website Safety Ratings and Secure Search	siteadvisor.com
Kohl's Department Stores | Shop Apparel, Handbags, Jewelry, Shoes, Home, Kitchen, Accessories, Toys & Kids'	kohls.com
Large Porn Tube. Free tube porn videos, free sex, full length streaming sex videos.	largeporntube.com
	rakuten.ne.jp
vente-privee.com: designer brands for smart shoppers	vente-privee.com
	nasa.gov
华军软件园-提供国内外最新免费软件、共享软件下载及发布的软件下载站，软件资讯、技巧、评测、教程等相关软件资讯！	onlinedown.net
伊莉討論區	eyny.com
51CTO.COM - 技术成就梦想 - 中国领先的IT技术网站	51cto.com
MercadoLibre Venezuela - Donde comprar y vender de todo.	mercadolibre.com.ve
iDNES.cz – zprávy, kterým můžete věřit	idnes.cz
Mac Rumors: Apple Mac iOS Rumors and News You Care About	macrumors.com
【糯米网】-团购网站-高品质、低折扣，为您提供最好的团购服务	nuomi.com
Cool Websites, Software and Internet Tips	makeuseof.com
QuiBids, Welcome to QuiBids Online Auctions! - QuiBids.com	quibids.com
Project management software, online collaboration: Basecamp	basecamphq.com
Marktplaats - De plek om Nieuwe en Tweedehands spullen te kopen en verkopen	marktplaats.nl
SFR : T&eacute;l&eacute;phone, Forfait, Offres ADSL, Fibre, Mobile + Internet	sfr.fr
	klikbca.com
Tin tuc 24h | tin nhanh bong da | the thao | thoi trang, giai tri vn | báo online	24h.com.vn
Betfair.com: Online Betting, Sports Betting, Horse Racing, Football | Bet Poker, Casino &amp; Games	betfair.com
glispa :: Performance Marketing	glispa.com
Shopping Cart & Ecommerce Software - 1ShoppingCart.com	mcssl.com
CRI Online	chinabroadcast.cn
OnlyLady女人志 - 专业女性网，时尚、生活、互动女性网站平台	onlylady.com
Flights, Cheap Hotels at MakeMyTrip - India's No 1 Travel Site | Guaranteed Low Cost Air Tickets, Bus, Book Holiday Packages &amp; Rail Tours Online	makemytrip.com
	iteye.com
	slando.ru
威客-猪八戒网，中国最大的威客网站	zhubajie.com
PagesJaunes : Annuaire des professionnels et bonnes adresses	pagesjaunes.fr
4chan	4chan.org
FOCUS Online - Nachrichten	focus.de
Free Online Storage &amp; File Upload with FileServe	fileserve.com
Digital Photography Review	dpreview.com
Food Network - Easy Recipes, Healthy Eating Ideas and Chef Recipe Videos	foodnetwork.com
anonym.to | Anonym surfen | link to other sites anonymously	anonym.to
携程旅行网: 酒店预订, 机票预订及查询, 旅游度假, 商旅管理	ctrip.com
Nordstrom: Free Shipping. Free Returns. All the Time.	nordstrom.com
光明网_新闻视野、文化视角、思想深度、理论高度	gmw.cn
news.ORF.at	orf.at
Pastebin.com - #1 paste tool since 2002!	pastebin.com
METEO * Previsioni del Tempo Italia ed Europa | IL METEO.IT	ilmeteo.it
Google	google.com.ec
Developers	userapi.com
Subito.it	subito.it
Sydney Morning Herald - Business & World News Australia | smh.com.au	smh.com.au
	19lou.com
United Airlines - Airline Tickets, Vacations Packages, Travel Deals, and Company Information on united.com	united.com
FileSonic, fast and easy file storage.	filesonic.com
UK's number one property website for properties for sale and to rent	rightmove.co.uk
R7.com - Notícias, entretenimento, esportes e vídeos	r7.com
Patch	patch.com
昵图网网址 www.nipic.com	nipic.com
Bigpoint.com | Play the best online browser games for free	bigpoint.com
JUGEM(ジュゲム) | デザインにこだわったブログ作成と、ポップな最新エンタメニュースをお届け！	jugem.jp
Free Porn Videos, Free Sex, XXX, Free Porn Tube - EmpFlix	empflix.com
UOL Esporte	esporte.uol.com.br
News Worth Talking About | NetworkedBlogs by Ninua	networkedblogs.com
Video Game Cheats, Reviews, FAQs, Message Boards, and More - GameFAQs	gamefaqs.com
World business, finance, and political news from the Financial Times - FT.com	ft.com
	wansxd.com
アバスト! | 無料アンチウイルス または インターネットセキュリティ のダウンロード	avast.com
Help Desk Software | Support Ticket System | Zendesk.com	zendesk.com
SEO Book.com ~ SEO Training Made Easy	seobook.com
theCHIVE - Funny Photos and Funny Videos &#8211; Keep Calm and Chive On	thechive.com
Video One - free porn movies - video search	video-one.com
东方网	eastday.com
Радикал-Фото - создай фотоальбом на любимом форуме - бесплатный хостинг фотографий	radikal.ru
	webmasterworld.com
Welcome to Examiner.com | Examiner.com	examiner.com
JumboFiles.com - Dedicated Hosting	jumbofiles.com
Sky.com - your home for the latest news, sport and entertainment	sky.com
ÅÝÅÝÍø£­µÚÒ»Êý×Ö²úÆ·»¥¶¯Ã½Ìå	pcpop.com
DB Bahn: bahn.de - Ihr Mobilitätsportal für Reisen, Bahn, Urlaub, Hotels, Städtereisen und Mietwagen	bahn.de
Welcome to Oron.com	oron.com
MOTHERLESS.COM - Go Ahead She Isn't Looking!	motherless.com
宣传易广告联盟——弹窗富媒体站长首选，十年品牌，值得信赖!	ads8.com
苏宁易购-苏宁电器网上商城，领先的综合网上购物商城，正品行货，全国联保，货到付款，让您尽享购物乐趣！	suning.com
ÓÐÎÊ±Ø´ðÍø_ºÃÒ½ÉúÔÚÏß_24Ð¡Ê±Ãâ·Ñ×ÉÑ¯ºÃÒ½Éú	120ask.com
	asahi.com
Boston.com - Boston, MA news, breaking news, sports, video	boston.com
Novinky.cz &nbsp;&ndash;&nbsp;nejčtenější zprávy na českém internetu	novinky.cz
Sky Sports | Sport News	skysports.com
NPR : National Public Radio : News &amp; Analysis, World, US, Music &amp; Arts : NPR	npr.org
Watch Series Online for free, Full episodes - Watch Series	watchseries.eu
Ask.fm	ask.fm
[ MétéoFrance ]	meteofrance.com
XHamsterCams - Live Sex Chat, Sex Shows and Webcam Sex - Amateur Cams and Pornstars	xhamstercams.com
网上车市-国产汽车-进口汽车-第一汽车购买顾问	cheshi.com.cn
Redirecting	goo.gl
Biglion – купоны на скидки в Москве. Купи купон со скидкой на лучшие акции и распродажи, сайт каталог скидок дня.	biglion.ru
	ppstream.com
Clarín.com	clarin.com
Extabit.com - file hosting	extabit.com
XDating.com - Free online Dating Sites & Service for casual dates	xdating.com
World News	wn.com
Freeones: アルティメットスーパーモデル - 有名人 - ポルノスターリンクサイト	freeones.com
docin.com豆丁网 - 分享文档 发现价值	docin.com
Welcome to OnlineSBI	onlinesbi.com
YOKA时尚网-态度创造时尚	yoka.com
ข่าว ดูดวง เกมส์ ฟังเพลง หวย ช้อปปิ้ง : Sanook.com	sanook.com
Live Cams | Live Sex Chat And Webcam Expert Advice at ImLive	imlive.com
	blogspot.com.au
	cloudfront.net
Votre programme TV avec Télé Loisirs : le programme t&eacute;l&eacute;vision grandes cha&icirc;nes, TNT et c&acirc;ble	programme-tv.net
Free software download,Over 200000 software free downloads	brothersoft.com
JEUXVIDEO.COM - La Référence des Jeux Vidéo sur PC et Consoles !	jeuxvideo.com
Search Engine Land: Must Read News About Search Marketing &amp; Search Engines	searchengineland.com
Site Meter - Counter and Statistics Tracker	sitemeter.com
インテルのホームページへようこそ	intel.com
Delta Air Lines - Airline Tickets and Airfare to Worldwide Destinations	delta.com
1&amp;1 Internet - Home	1and1.com
Free Email Addresses: Web based and secure Email - mail.com	mail.com
:: TRAIDNT FORUM :: - Powered by vBulletin	traidnt.net
MarketGid: Первый виртуальный торгово-развлекательный центр	marketgid.com
Grooveshark - Free Music Streaming, Online Music	grooveshark.com
Open Site Explorer	opensiteexplorer.org
	yiqifa.com
네이트	nate.com
Nachrichten aus Politik, Kultur, Wirtschaft und Sport - sueddeutsche.de	sueddeutsche.de
MYTF1 : Infos, &eacute;missions, s&eacute;ries US, TF1 en live et replay - TF1	tf1.fr
Funny Videos, Funny Clips &amp; Funny Pictures | Break.com	break.com
辞典・百科事典の検索サービス - Weblio辞書	weblio.jp
lanacion.com - Las noticias que importan y los temas que interesan	lanacion.com.ar
DTI ブログ 無料アクセス解析付き、アフィリエイト可	dtiblog.com
Сбербанк России
 :: Главная страница :: Вклад «Победитель»	sbrf.ru
Managed DNS | Outsourced DNS | Anycast DNS	dyndns.org
::17173.com::中国游戏第一门户站	17173.com
Firstload is your Usenet Access!	firstload.com
天空下载：提供国内外最新免费软件、共享软件下载	skycn.com
华声在线	voc.com.cn
Porno Tube, Free Porn Videos, XXX, Pussy, Porno Movies & Pics	sunporno.com
eBay - Deals on new and used electronics, clothing, collectables and more on eBay	ebay.ca
Home | Ubuntu	ubuntu.com
Costco.com: Offering thousands of items you won’t find in your local Costco.	costco.com
	sdo.com
Web Hosting Talk - The largest, most influential web hosting community on the Internet	webhostingtalk.com
	itmedia.co.jp
@wiki（ アット ウィキ ）無料 wiki レンタルサービス	atwiki.jp
Google	google.com.ly
Tickets for Concerts, Sports, Arts, Theater, Family, Events, more. Official Ticketmaster site	ticketmaster.com
Opera browser | Faster &amp; safer internet | Free download	opera.com
安卓网-中国最大Android手机垂直门户	hiapk.com
	mogujie.com
Made-in-China.com China manufacturer directory, China products, China suppliers, China trade, China factory	made-in-china.com
Download Accelerator Plus (DAP) - Free Download Manager &amp; Video Downloader	speedbit.com
Sportnachrichten - kicker online	kicker.de
Connect with EarthLink, the award-winning Internet service provider (ISP) you can trust!	earthlink.net
Free Classifieds - ClassifiedsGiant	classifiedsgiant.com
Livestream. Discover and Experience Live Events. Broadcast your own events live with our Platform and Services.	livestream.com
FileCrop - Search and Download Rapidshare Mediafire and Hotfile Files	filecrop.com
Nike - Please choose your Nike region	nike.com
B&amp;H Photo Video Digital Cameras, Photography, Camcorders	bhphotovideo.com
